╔══════════════════════════════════════════════════════════╗
║                           RDC                            ║
╚══════════════════════════════════════════════════════════╝
┌─────┬──────────────────────────────────────────────┬─────┐
│     │                                              │     │
│     │                                              │     │
│     │                                              │     │
│     │                                              │     │
│     │                                              │     │
│     │                                              │     │
│     │                                              │     │
│     │                                              │     │
│     │                                              │     │
│     │                                              │     │
│     │                                              │     │
│     │                                              │     │
│     │                                              │     │
│     │                                              │     │
│    ┌┴┐                                            ┌┴┐    │
│    │A│                                            │C│    │
│    └┬┘                                            └┬┘    │
│     │                                              │     │
│     │                                              │     │
│     │                                              │     │
│     │                                              │     │
│     │                                              │     │
│     │                                              │     │
│     │                                              │     │
│     │                                              │     │
│     │                                              │     │
│     │                                              │     │
│     │                                              │     │
│     │                                              │     │
│     │                                              │     │
│     │                                              │     │
│     │                      ┌─┐                     │     │
│     └──────────────────────┤B├─────────────────────┘     │
│                            └─┘                           │
│                                                          │
│                                                          │
│                                                          │
│                                                          │
└──────────────────────────────────────────────────────────┘